IHHHHHHHHHHHHHHHHHHHHHHHD                        IHHHHHHHHHHHHHHHHHHHHHHHHD                        IHHHHHHHHHHHHHHHHHHHHHHHHD
VRRRRRRRRRRRRRRRRRRRRRRRV                        VRRRRRRRRRRRRRRRRRRRRRRRRV                        VRRRRRRRRRRRRRRRRRRRRRRRRV
VPPPPPPPPPPPPPPPPPPPPPPPV                        VPPPPPPPPPPPPPPPPPPPPPPPPV                        VPPPPPPPPPPPPPPPPPPPPPPPPV
VPPPPPPPPPPPPPPPPPPPPPPPLHHHHHHHHHHHHHHHHHHHHHHHHJPPPPPPPPPPPPPPPPPPPPPPPPLHHHHHHHHHHHHHHHHHHHHHHHHJPPPPPPPPPPPPPPPPPPPPPPPPV
VWWWWWWWWWWWWWWWWWWWWWWWRRRRRRRRRRRRRRRRRRRRRRRRRRWWWWWWWWWWWWWWWWWWWWWWWWRRRRRRRRRRRRRRRRRRRRRRRRRRWWWWWWWWWWWWWWWWWWWWWWWWV
VAAAAAAAAAAAAAAAAAAAAAAAPPPPPPPPPPPPPPPPPPPPPPPPPPAAAAAAAAAAAAAAAAAAAAAAAAPPPPPPPPPPPPPPPPPPPPPPPPPPAAAAAAAAAAAAAAAAAAAAAAAAV
VAAAAAAAAAAAAAAAAAAAAAAAPPPPPPPPPPPPPPPPPPPPPPPPPPAAAAAAACAAAAAAAAAACAAAAAPPPPPPPPPPPPPPPPPPPPPPPPPPAAAAAAAAAAAAAAAAAAAAAAAAV
VAAAAAAAAAAAAAAAAAAAAAAAWWWWWWWWWWWWWWWWWWWWWWWWWWAAAAAAAAAAAAAAAAAAAAAAAAWWWWWWWWWWWWWWWWWWWWWWWWWWAAAAAAAAAAAAAAAAAAAAAAAAV
VAAAAAAAAAAAAAAAAAAAAAAAAAAAAAAACAAAAAAAAAAAAAAAAAAAAAAAAAAAAAAAAAAAAAAAAAAAAAAAAAAAAAAAAAAAAAAAAAAAAAAAAAAAAAAAAAAAAAAAACAAV
VAAAAAAAAAAAAAAAAAAAAAAAAAAAAAAAAAAAAAAAAAAAAAAAAAAAAAAAAAAAAAAAAAAAAAAAAAAAAAAAAAAAAAAAAAAAAAAAAAAAAAAAAAAAAAAAAAAAAAAAAAAAV
VAAAAAAAAAAAAAAAAAAAAAAAAAAAAAAAAAAAAAAAAAAAAAAAAAAAAAAAAAAAAAAAAAAAAAAAAAAAAAAAAAAAAAAAAAAAAAAAAAAAAAAAAAAACAAAAAAAAAAAAAAAV
VAAAAAAAAAAAAAAAAAAAAAAAIHHHHHHHHHHHHHHHHHHHHHHHHHDAAAAAAAAAAAAAAAAAAAAAAAIHHHHHHHHHHHHHHHHHHHHHHHHHDAAAAAAAAAAAAAAAAAAAAAAAV
LHHHHHHHHHHHHHHHHHHHHHHHJPPPPPPPPPPPPPPPPPPPPPPPPPLHHHHHHHHHHHHHHHHHHHHHHHJPPPPPPPPPPPPPPPPPPPPPPPPPLHHHHHHHHHHHHHHHHHHHHHHHJ
PPPPPPPPPPPPPPPPPPPPPPPPPPPPPPPPPPPPPPPPPPPPPPPPPPPPPPPPPPPPPPPPPPPPPPPPPPPPPPPPPPPPPPPPPPPPPPPPPPPPPPPPPPPPPPPPPPPPPPPPPPPPP
PPPPPPPPPPPPPPPPPPPPPPPPPWWWWWWWWWWWWWWWWWWWWWWWWWPPPPPPPPPPPPPPPPPPPPPPPPPWWWWWWWWWWWWWWWWWWWWWWWWWPPPPPPPPPPPPPPPPPPPPPPPPP
WWWWWWWWWWWWWWWWWWWWWWWWW                         WWWWWWWWWWWWWWWWWWWWWWWWW                         WWWWWWWWWWWWWWWWWWWWWWWWW